農水省=Ministry of Agriculture, Forestry and Fisheries (MAFF)
輸出=export
産地=production area
県協議会=prefectural council
補助=subsidy
需要開拓=market development
規制=regulation
体制整備=system development
予算=budget
生産=production
販売=sales
ＧＦＰフラッグシップ輸出産地形成プロジェクト=GFP Flagship Export Production Area Formation Project
ＪＡ=Japan Agricultural Cooperatives
地域商社=local trading company
協議会=council
公募=open call
農薬=agricultural chemicals
食品=food
相手国=partner country
鮮度=freshness
物流網=logistics network
営農指導員=agricultural instructor
コンサルタント=consultant
地域の輸出商社=local export trading company
有機農業=organic agriculture
新品種=new variety
生産方法=production method
コールドチェーン=cold chain
低温流通=low-temperature distribution
混載=mixed loading
地方港湾=local port
輸出支援プラットフォーム=export support platform
現地市場=local market
産品=product
牛肉=beef
リンゴ=apple
輸出重点品目=export priority items
改植=replanting
新植=new planting
経費=expenses
有機栽培=organic cultivation
種子=seeds
種苗=seedlings
生産資材=production materials
購入代=purchase price
助成=subsidy
生産・流通コスト=production and distribution cost
低減=reduction